你好——問候或善意的表達
外展 - 拉開，如通過肌肉的動作; 綁架。
kith - 一個老式的術語，指的是熟悉的朋友、鄰居或親戚。 它經常用在短語“kith and kin”中，意思是“朋友和親戚”。
白天 - 一晚和下一晚之間的光照時間。
首先 - 在時間、順序或重要性上領先於所有其他人：例如。
蘋果 - 玫瑰科通常栽培的樹（海棠屬）的肉質、通常圓形的紅色、黃色或綠色可食用仁果
黃油——脂肪球、空氣和水的固體乳液，通過攪拌牛奶或奶油製成並用作食物”
接受 - 被接受或接受的質量或狀態
訪問 - 允許、自由或進入、接近或往返某個地方或接近或與人或事物交流的能力
accord - 給予或給予特別是適當的、應得的或賺取的
石榴糖漿 - 由石榴汁製成的稀糖漿； 用於混合飲料
石榴 - 灌木或小樹，有大的紅色多籽果實
hefty - 相當大的重量和尺寸
唐菖蒲 - 主要原產於熱帶和南非的唐菖蒲屬的眾多植物中的任何一種，具有劍形葉子和顏色鮮豔的漏斗狀花朵的單側穗狀花序； 廣為栽培
pelter - 導彈投擲者
具體化 - 使某物具體化
人體模型——用於展示衣服的真人大小的假人
遊說——通過提出具體問題徵求意見
lubberly - 笨拙和不熟練的
親切的 - 禮貌地熱情友好
詼諧的 - 以笑話和幽默為特徵
烏托邦的 - 屬於或關於或類似於烏托邦的
tamp——緊緊地壓下去
subnormality - 低於正常的狀態
obbligato - 樂譜中必須演奏的部分，不得更改或遺漏
woodsy - 樹林的特徵或暗示
ha - 響亮的笑聲，聽起來像馬的嘶鳴
裝卸工人——在港口裝卸船隻的工人
冒泡 - 氣體逸出時冒泡的過程
bromidic - 喜歡說溴化物
canoodle - 深情地撫摸或撫摸
satrap - 古代波斯省的總督
congeries - 許多異質事物的總和
twain - 兩個相同的項目
kittiwake - 北部地區的小珍珠灰色海鷗
多義性——單個單詞或短語的歧義，可以用來（在不同的上下文中）表達兩個或多個不同的含義
madrigal - 一首無伴奏的多聲部歌曲
護柱 - 一個強大的職位
暴發戶 - 突然上升到更高經濟地位的人
bowdlerize - 通過省略或修改被認為不雅的部分來編輯
江湖騙子 - 華麗的騙子
傲慢 - 傲慢自大，以優越的態度對待下等人
Asphodel - 長水仙屬和長水仙屬的各種主要地中海植物中的任何一種，具有線形葉子和白色或粉紅色或黃色花朵的總狀花序
廢止 - 正式或合法的取消
準 - 有一些相似之處
南斯拉夫 - 前東南歐國家，毗鄰亞得里亞海； 1918年成立，1929年定名為南斯拉夫； 由鐵托元帥控制為共產主義國家，直到他於 1980 年去世
古植物學 - 化石植物的研究
頭足類 - 與頭足類有關或屬於頭足類
塞爾維亞語 - 屬於或與塞爾維亞地區的人民、語言或文化有關的
審裁處 - 處理司法事務的集會
ague - 瘧疾症狀的發冷和發燒
荷蘭 - 西歐北海的君主立憲制國家
波斯尼亞的 - 波斯尼亞和黑塞哥維那或波斯尼亞人民的或與之有關或具有波斯尼亞人民的特徵
阿爾巴尼亞語 - 屬於或關於阿爾巴尼亞或其人民或語言或文化
科索沃 - 巴爾幹半島的一個共和國，於 2008 年宣布脫離塞爾維亞獨立； 主要由阿爾巴尼亞人居住
智利 - 南美洲南部的一個共和國，位於南太平洋沿岸安第斯山脈西坡
羞辱 - 導致尷尬或意識到你的缺點
蘇哈托 - 印度尼西亞政治家，1967 年從蘇加諾手中奪權
考慮 - 為精神目的而專心和詳細地思考
秘魯人的 - 秘魯或其人民的或與之相關的或具有其特徵的
驅逐 - 從一個職位或辦公室中刪除
隨後 - 發生在比另一時間晚的時間
大屠殺——對許多人的野蠻和過度殺戮
平民 - 非軍事公民
反抗——起來反抗權威
法西斯主義者 - 右翼威權主義觀點的擁護者
崇敬 - 深感榮幸
政權 - 一個政治單位的管理權力
曼德拉 - 南非政治家，1994 年出獄後成為該國第一位民選總統（生於 1918 年）
勝利地-以勝利的方式
比勒陀利亞 - 德蘭士瓦的城市
culminate - 結束，尤指達到最後或高潮階段
assassined - 因政治原因被突然襲擊殺害
費迪南德 - 卡斯蒂利亞和萊昂的國王，控制了薩拉戈薩、塞維利亞和托萊多的摩爾人國王（1016-1065 年）
蘇哈托 - 印度尼西亞政治家，1967 年從蘇加諾手中奪權
緬甸語 - 緬甸或其人民的或與之相關的或具有緬甸或其人民的特徵
北京——位於中國東北部河北省的中華人民共和國首都； 中國第二大城市
吉爾吉斯斯坦——中亞西部的一個內陸共和國，與中國西北部接壤； 前身為亞洲蘇聯，但於 1991 年獨立
委內瑞拉 - 南美洲北部加勒比地區的一個共和國
有魅力的 - 具有非凡的吸引力
daw - 常見的黑灰色歐亞鳥類，以盜竊著稱
高潮 - 突然或突然的強烈增加
選舉權——合法的投票權
最小的 - 最少的
叛亂 - 旨在推翻政府的有組織的叛亂
酷刑——施加痛苦以懲罰或獲取信息
危地馬拉 - 中美洲共和國
孟加拉國——南亞的一個穆斯林共和國，北部、西部和東部與印度接壤，南部與孟加拉灣接壤； 以前是印度的一部分，然後是巴基斯坦的一部分； 它於1971年獲得獨立
操縱 - 巧妙地或狡猾地影響或控制
玻利維亞 - 南美洲中部的內陸共和國
嚴格 - 要求嚴格遵守規則和程序
易受傷害的 - 能夠受傷或受傷
prod - 輕輕推
飢荒 - 導致飢餓和死亡的嚴重食物短缺
eradicate - 徹底摧毀，彷彿連根拔起