hallo - een begroeting of uiting van goede wil
abducent - wegtrekken, zoals door de werking van een spier; ontvoeren.
kith - een ouderwetse term die verwijst naar bekende vrienden, buren of familieleden. Het wordt vaak gebruikt in de uitdrukking 'vrienden en verwanten', wat 'vrienden en familieleden' betekent.
dag - de tijd van licht tussen de ene nacht en de volgende.
eerst - voorafgaand aan alle anderen in tijd, volgorde of belangrijkheid: zoals."
appel - de vlezige, meestal afgeronde rode, gele of groene eetbare pitvrucht van een meestal gekweekte boom (geslacht Malus) van de rozenfamilie
boter - een vaste emulsie van vetbolletjes, lucht en water gemaakt door melk of room te karnen en gebruikt als voedsel"
acceptatie - de kwaliteit of staat van geaccepteerd of acceptabel zijn
toegang - toestemming, vrijheid of mogelijkheid om een plaats binnen te gaan, te benaderen of te passeren of om een persoon of ding te benaderen of ermee te communiceren
accord - toe te kennen of te geven, in het bijzonder zoals gepast, verschuldigd of verdiend
grenadine - dunne siroop gemaakt van granaatappelsap; gebruikt in mixdrankjes
granaatappel - struik of kleine boom met grote rode vruchten met veel zaden
fors - van aanzienlijk gewicht en omvang
gladiolen - een van de vele planten van het geslacht Gladiolus, voornamelijk inheems in tropisch en Zuid-Afrika met zwaardvormige bladeren en eenzijdige punten van felgekleurde trechtervormige bloemen; wijd verbouwd
Pelter - een werper van raketten
concretiseren - iets concreet maken
oefenpop - een levensgrote pop die wordt gebruikt om kleding uit te stallen
canvassen - krijg meningen door specifieke vragen te stellen
lubberly - onhandig en ongeschoold
hartelijk - beleefd warm en vriendelijk
grappig - gekenmerkt door grappen en een goed humeur
Utopisch - van of behorend tot of lijkend op een utopie
aanstampen - stevig aandrukken
subnormaliteit - de toestand van minder zijn dan normaal
obbligato - een deel van de partituur dat moet worden uitgevoerd zonder verandering of weglating
bosachtig - karakteristiek of suggestief voor bossen
ha - een luide lach die klinkt als een hinnikend paard
stuwadoor - een arbeider die schepen in een haven laadt en lost
bruisen - het proces van borrelen als gas ontsnapt
bromidisch - gegeven aan het uiten van bromiden
canoodle - liefdevol strelen of aaien
satraap - een gouverneur van een provincie in het oude Perzië
congeries - een optelsom van veel heterogene dingen bij elkaar
twain - twee items van dezelfde soort
drieteenmeeuw - kleine parelgrijze meeuw van noordelijke regio's
polysemie - de ambiguïteit van een individueel woord of zin die kan worden gebruikt (in verschillende contexten) om twee of meer verschillende betekenissen uit te drukken
madrigaal - een niet-begeleide meerstemmige partijzang
bolder - een sterke paal
parvenu - een persoon die plotseling is opgeklommen tot een hogere economische status
bowdlerize - bewerken door delen die als onkies worden beschouwd weg te laten of te wijzigen
mountebank - een flamboyante bedrieger
hauteur - aanmatigende trots met een superieure manier van doen tegenover ondergeschikten
asphodel - een van de verschillende voornamelijk mediterrane planten van de geslachten Asphodeline en Asphodelus met lineaire bladeren en trossen witte of roze of gele bloemen
nietigverklaring - een officiële of wettelijke annulering
quasi - enige gelijkenis vertonen
Joegoslavië - een voormalig land in Zuidoost-Europa dat grenst aan de Adriatische Zee; opgericht in 1918 en Joegoslavië genoemd in 1929; gecontroleerd door maarschalk Tito als een communistische staat tot aan zijn dood in 1980
paleobotanie - de studie van fossiele planten
cephalopodan - gerelateerd aan of behorend tot de klasse Cephalopoda
Servisch - van of gerelateerd aan de mensen of taal of cultuur van de regio van Servië
tribunaal - een vergadering om gerechtelijke zaken af te handelen
koorts - koude rillingen en koorts die symptomatisch zijn voor malaria
Nederland - een constitutionele monarchie in West-Europa aan de Noordzee
Bosnisch - van of gerelateerd aan of kenmerkend voor Bosnië-Herzegovina of de bevolking van Bosnië
Albanees - van of met betrekking tot Albanië of zijn mensen of taal of cultuur
Kosovo - een republiek op het Balkanschiereiland die zich in 2008 onafhankelijk verklaarde van Servië; overwegend bevolkt door Albanezen
Chili - een republiek in het zuiden van Zuid-Amerika op de westelijke hellingen van de Andes aan de zuidkust van de Stille Oceaan
vernederend - in verlegenheid brengen of bewust worden van uw tekortkomingen
Soeharto - Indonesische staatsman die in 1967 de macht greep van Soekarno
contemplate - denk aandachtig en lang na, zoals voor spirituele doeleinden
Peruaans - van of gerelateerd aan of kenmerkend voor Peru of zijn volk
verdrijven - verwijderen uit een positie of kantoor
vervolgens - gebeurt op een later tijdstip dan een ander tijdstip
bloedbad - de woeste en buitensporige moord op veel mensen
burger - een niet-militaire burger
in opstand komen - in opstand komen tegen een autoriteit
fascist - een aanhanger van rechtse autoritaire opvattingen
vereerd - diep vereerd
regime - de regerende autoriteit van een politieke eenheid
Mandela - Zuid-Afrikaanse staatsman die uit de gevangenis werd vrijgelaten om in 1994 de eerste democratisch gekozen president van het land te worden (geboren in 1918)
triomfantelijk - op een triomfantelijke manier
Pretoria - stad in Transvaal
hoogtepunt - einde, vooral om een laatste of klimatologische fase te bereiken
vermoord - vermoord door verrassingsaanval om politieke redenen
Ferdinand - koning van Castilië en Leon die de controle over de Moorse koningen van Saragossa en Sevilla en Toledo verwierf (1016-1065)
Soeharto - Indonesische staatsman die in 1967 de macht greep van Soekarno
Birmees - van of gerelateerd aan of kenmerkend voor Myanmar of zijn volk
Beijing - hoofdstad van de Volksrepubliek China in de provincie Hebei in het noordoosten van China; 2e grootste Chinese stad
Kirgizië - een geheel door land omgeven republiek in het westen van Centraal-Azië, grenzend aan het noordwesten van China; voorheen een Aziatische sovjet maar werd onafhankelijk in 1991
Venezuela - een republiek in het noorden van Zuid-Amerika in het Caribisch gebied
charismatisch - een buitengewoon vermogen om aan te trekken
daw - gewone zwart-grijze Euraziatische vogel die bekend staat om zijn diefstal
upsurge - een plotselinge of abrupte sterke toename
kiesrecht - een wettelijk stemrecht
minimaal - zo min mogelijk
opstand - een georganiseerde opstand gericht op het omverwerpen van een regering
foltering - toebrengen van lijden om te straffen of informatie te verkrijgen
Guatemala - een republiek in Midden-Amerika
Bangladesh - een moslimrepubliek in Zuid-Azië, begrensd door India in het noorden en westen en oosten en de Golf van Bengalen in het zuiden; voorheen onderdeel van India en vervolgens onderdeel van Pakistan; het bereikte de onafhankelijkheid in 1971
manipuleren - slim of sluw beïnvloeden of beheersen
Bolivia - een geheel door land omgeven republiek in centraal Zuid-Amerika
stringent - strikte aandacht voor regels en procedures eisen
kwetsbaar - in staat om gewond of gekwetst te worden
prod - duw zachtjes tegen
hongersnood - een ernstig tekort aan voedsel met hongersnood en dood tot gevolg
uitroeien - volledig vernietigen, alsof het tot aan de wortels toe is