bonjour - une salutation ou une expression de bonne volonté
abducteur - s'éloignant, comme par l'action d'un muscle; enlèvement.
kith - un terme démodé qui fait référence à des amis, des voisins ou des parents familiers. Il est souvent utilisé dans l'expression "amis et parents", qui signifie "amis et parents".
jour - le temps de lumière entre une nuit et la suivante.
premier - précédant tous les autres dans le temps, l'ordre ou l'importance : tel que."
pomme - le fruit à pépins charnu, généralement arrondi, rouge, jaune ou vert comestible d'un arbre habituellement cultivé (genre Malus) de la famille des roses
beurre - une émulsion solide de globules gras, d'air et d'eau obtenue en barattant du lait ou de la crème et utilisée comme aliment"
acceptation - la qualité ou l'état d'être accepté ou acceptable
accès - permission, liberté ou capacité d'entrer, d'approcher ou de passer vers et depuis un lieu ou d'approcher ou de communiquer avec une personne ou une chose
accord - accorder ou donner spécialement comme approprié, dû ou mérité
grenadine - sirop léger à base de jus de grenade; utilisé dans les boissons mélangées
grenade - arbuste ou petit arbre ayant de gros fruits rouges à nombreuses graines
lourd - d'un poids et d'une taille considérables
glaïeul - l'une des nombreuses plantes du genre Gladiolus originaire principalement d'Afrique tropicale et du Sud ayant des feuilles en forme d'épée et des épis unilatéraux de fleurs en forme d'entonnoir aux couleurs vives ; largement cultivé
Pelter - un lanceur de missiles
concrétiser - rendre quelque chose de concret
mannequin - un mannequin grandeur nature utilisé pour afficher les vêtements
démarchage - obtenir des avis en posant des questions spécifiques
lubberly - maladroit et non qualifié
cordial - poliment chaleureux et amical
joculaire - caractérisé par des blagues et de la bonne humeur
Utopique - de ou se rapportant à ou ressemblant à une utopie
tasser - appuyer fermement
sous-normalité - l'état d'être moins que la normale
obbligato - une partie de la partition qui doit être exécutée sans changement ni omission
boisé - caractéristique ou évocateur des bois
ha - un rire bruyant qui ressemble à un hennissement de cheval
stevedore - un ouvrier qui charge et décharge des navires dans un port
effervescence - le processus de bouillonnement lorsque le gaz s'échappe
bromodique - donné à émettre des bromures
canoodle - caresser ou caresser affectueusement
satrape - gouverneur d'une province de l'ancienne Perse
congeries - une somme totale de nombreuses choses hétérogènes prises ensemble
twain - deux articles du même genre
mouette tridactyle - petite mouette gris perle des régions du nord
polysémie - l'ambiguïté d'un mot ou d'une phrase individuelle qui peut être utilisée (dans différents contextes) pour exprimer deux ou plusieurs significations différentes
madrigal - une partie de chant non accompagnée pour plusieurs voix
borne - un poteau solide
parvenu - une personne qui a soudainement atteint un statut économique supérieur
bowdlerize - modifier en omettant ou en modifiant des parties considérées comme indélicates
saltimbanque - un trompeur flamboyant
hauteur - fierté dominatrice avec une manière supérieure envers les inférieurs
asphodèle - l'une des diverses plantes principalement méditerranéennes des genres Asphodeline et Asphodelus ayant des feuilles linéaires et des grappes de fleurs blanches ou roses ou jaunes
annulation - une annulation officielle ou légale
quasi - ayant une certaine ressemblance
Yougoslavie - un ancien pays du sud-est de l'Europe bordant la mer Adriatique; formé en 1918 et nommé Yougoslavie en 1929; contrôlé par le maréchal Tito en tant qu'État communiste jusqu'à sa mort en 1980
paléobotanique - l'étude des plantes fossiles
cephalopodan - lié ou appartenant à la classe Cephalopoda
Serbe - de ou lié au peuple ou à la langue ou à la culture de la région de Serbie
tribunal - une assemblée pour mener des affaires judiciaires
fièvre - frissons et fièvre symptomatiques du paludisme
Pays-Bas - une monarchie constitutionnelle en Europe occidentale sur la mer du Nord
Bosniaque - de ou relatif à ou caractéristique de la Bosnie-Herzégovine ou du peuple de Bosnie
Albanais - de ou lié à l'Albanie ou à son peuple ou sa langue ou sa culture
Kosovo - une république de la péninsule balkanique qui a déclaré son indépendance de la Serbie en 2008 ; peuplé majoritairement d'Albanais
Chili - une république du sud de l'Amérique du Sud sur le versant ouest des Andes sur la côte sud du Pacifique
humiliant - causant de l'embarras ou la prise de conscience de vos lacunes
Suharto - Homme d'État indonésien qui a pris le pouvoir à Sukarno en 1967
contempler - penser intensément et longuement, comme à des fins spirituelles
Péruvien - de ou lié à ou caractéristique du Pérou ou de son peuple
évincer - retirer d'un poste ou d'un bureau
par la suite - se produisant à un moment plus tard qu'un autre moment
massacre - le meurtre sauvage et excessif de nombreuses personnes
civil - un citoyen non militaire
se révolter - s'élever contre une autorité
fasciste - adepte des opinions autoritaires de droite
vénéré - profondément honoré
régime - l'autorité dirigeante d'une unité politique
Mandela - Homme d'État sud-africain qui a été libéré de prison pour devenir le premier président démocratiquement élu du pays en 1994 (né en 1918)
triomphalement - d'une manière triomphale
Pretoria - ville du Transvaal
culminer - finir, en particulier pour atteindre une étape finale ou culminante
assassiné - assassiné par une attaque surprise pour des raisons politiques
Ferdinand - roi de Castille et Léon qui a pris le contrôle des rois maures de Saragosse et de Séville et de Tolède (1016-1065)
Suharto - Homme d'État indonésien qui a pris le pouvoir à Sukarno en 1967
Birman - de ou lié à ou caractéristique du Myanmar ou de son peuple
Pékin - capitale de la République populaire de Chine dans la province du Hebei au nord-est de la Chine ; 2ème plus grande ville chinoise
Kirghizistan - une république enclavée dans le centre-ouest de l'Asie bordant le nord-ouest de la Chine ; ancien soviet asiatique mais devenu indépendant en 1991
Venezuela - une république du nord de l'Amérique du Sud dans les Caraïbes
charismatique - possédant une extraordinaire capacité à attirer
daw - oiseau eurasien noir et gris commun connu pour le vol
recrudescence - une forte augmentation soudaine ou abrupte
suffrage - un droit légal de voter
minimal - le moins possible
insurrection - une rébellion organisée visant à renverser un gouvernement
torture - infliger des souffrances pour punir ou obtenir des informations
Guatemala - une république d'Amérique centrale
Bangladesh - une république musulmane du sud de l'Asie bordée par l'Inde au nord, à l'ouest et à l'est et la baie du Bengale au sud ; anciennement partie de l'Inde puis partie du Pakistan; il a accédé à l'indépendance en 1971
manipuler - influencer ou contrôler astucieusement ou sournoisement
Bolivie - une république enclavée au centre de l'Amérique du Sud
rigoureux - exigeant une attention stricte aux règles et procédures
vulnérable - capable d'être blessé ou blessé
prod - poussez doucement contre
famine - une grave pénurie de nourriture entraînant la famine et la mort
éradiquer - détruire complètement, comme si jusqu'aux racines