hola - un saludo o expresión de buena voluntad
abducent - alejándose, como por la acción de un músculo; abduciendo
pariente - un término anticuado que se refiere a amigos familiares, vecinos o parientes. A menudo se usa en la frase "parientes y amigos", que significa "amigos y parientes".
día - el tiempo de luz entre una noche y la siguiente.
primero - precediendo a todos los demás en tiempo, orden o importancia: como ".
manzana - la fruta pomácea carnosa, generalmente redondeada, roja, amarilla o verde comestible de un árbol generalmente cultivado (género Malus) de la familia de las rosáceas
mantequilla - una emulsión sólida de glóbulos de grasa, aire y agua hecha batiendo leche o crema y utilizada como alimento"
aceptación - la calidad o el estado de ser aceptado o aceptable
acceso: permiso, libertad o capacidad para entrar, acercarse o pasar hacia y desde un lugar o para acercarse o comunicarse con una persona o cosa
acuerdo - otorgar o dar especialmente según sea apropiado, debido o ganado
granadina - jarabe fino hecho de jugo de granada; utilizado en bebidas mezcladas
granada - arbusto o árbol pequeño que tiene una gran fruta roja de muchas semillas
fuerte - de considerable peso y tamaño
gladiolus - cualquiera de las numerosas plantas del género Gladiolus originarias principalmente de África tropical y de Sudáfrica que tienen hojas en forma de espada y espigas unilaterales de flores en forma de embudo de colores brillantes; ampliamente cultivado
pelter - un lanzador de misiles
concretar - hacer algo concreto
maniquí - un maniquí de tamaño natural que se usa para exhibir ropa
sondeo - obtenga opiniones haciendo preguntas específicas
lubberly - torpe e inexperto
cordial - cortésmente cálido y amistoso
jocoso - caracterizado por bromas y buen humor
Utópico - perteneciente o relativo a o parecido a una utopía
apisonar - presionar con fuerza
subnormalidad - el estado de ser menos de lo normal
obbligato - una parte de la partitura que debe ejecutarse sin cambios ni omisiones
amaderado - característico o sugestivo de maderas
ja - una risa fuerte que suena como un caballo relinchando
estibador - un trabajador que carga y descarga barcos en un puerto
efervescencia - el proceso de burbujeo a medida que se escapa el gas
bromídico - dado a pronunciar bromuros
canoodle - acariciar o acariciar cariñosamente
sátrapa - gobernador de una provincia en la antigua Persia
congeries - una suma total de muchas cosas heterogéneas tomadas juntas
twain - dos elementos del mismo tipo
kittiwake - pequeña gaviota gris perla de las regiones del norte
polisemia: la ambigüedad de una palabra o frase individual que se puede usar (en diferentes contextos) para expresar dos o más significados diferentes
madrigal - una parte sin acompañamiento para varias voces
bolardo - un poste fuerte
parvenu - una persona que de repente se ha elevado a un estatus económico más alto
bowdlerize - editar omitiendo o modificando partes consideradas poco delicadas
saltimbanqui - un engañador extravagante
hauteur - orgullo autoritario con una actitud superior hacia los inferiores
asfódelo - cualquiera de varias plantas principalmente mediterráneas de los géneros Asphodeline y Asphodelus que tienen hojas lineales y racimos de flores blancas, rosadas o amarillas
anulación - una cancelación oficial o legal
cuasi - que tiene alguna semejanza
Yugoslavia: un antiguo país del sureste de Europa que bordea el mar Adriático; formado en 1918 y nombrado Yugoslavia en 1929; controlado por el Mariscal Tito como estado comunista hasta su muerte en 1980
paleobotánica - el estudio de las plantas fósiles
cephalopodan - relacionado o perteneciente a la clase Cephalopoda
Serbio - de o relacionado con el pueblo, el idioma o la cultura de la región de Serbia
tribunal - una asamblea para llevar a cabo asuntos judiciales
ague - escalofríos y fiebre que son sintomáticos de la malaria
Países Bajos: una monarquía constitucional en Europa occidental en el Mar del Norte
Bosnio - de, o relativo a, o característico de Bosnia-Herzegovina o del pueblo de Bosnia
albanés - de o relativo a Albania o su gente o idioma o cultura
Kosovo - una república en la Península Balcánica que declaró su independencia de Serbia en 2008; poblado predominantemente por albaneses
Chile - una república en el sur de América del Sur en la vertiente occidental de los Andes en la costa del Pacífico sur
humillante - causando vergüenza o conciencia de sus defectos
Suharto: estadista indonesio que tomó el poder de Sukarno en 1967
contemplar - pensar atentamente y extensamente, como para propósitos espirituales
Peruano - de o relativo a o característico de Perú o su gente
expulsar - remover de una posición u oficina
posteriormente - sucediendo en un momento posterior a otro momento
masacre - el asesinato salvaje y excesivo de muchas personas
civil - un ciudadano no militar
revuelta - levantarse contra una autoridad
fascista - partidario de puntos de vista autoritarios de derecha
venerado - profundamente honrado
régimen - la autoridad gobernante de una unidad política
Mandela: estadista sudafricano que salió de prisión para convertirse en el primer presidente elegido democráticamente de la nación en 1994 (nacido en 1918)
triunfalmente - de manera triunfante
Pretoria - ciudad en el Transvaal
culminar - final, especialmente para llegar a una etapa final o culminante
asesinado - asesinado por un ataque sorpresa por razones políticas
Fernando - rey de Castilla y León que logró el control de los reyes moros de Zaragoza y Sevilla y Toledo (1016-1065)
Suharto: estadista indonesio que tomó el poder de Sukarno en 1967
Birmano - de o relacionado con o característico de Myanmar o su gente
Beijing - capital de la República Popular China en la provincia de Hebei en el noreste de China; segunda ciudad china más grande
Kirguistán: una república sin salida al mar en el oeste de Asia central que limita con el noroeste de China; anteriormente un soviet asiático pero se independizó en 1991
Venezuela - una república en el norte de América del Sur en el Caribe
carismático - que posee una habilidad extraordinaria para atraer
daw - pájaro euroasiático común negro y gris conocido por el robo
aumento - un fuerte aumento repentino o abrupto
sufragio - un derecho legal a votar
mínimo - lo mínimo posible
insurgencia - una rebelión organizada destinada a derrocar a un gobierno
tortura - imposición de sufrimiento para castigar u obtener información
Guatemala - una república en América Central
Bangladesh: una república musulmana en el sur de Asia que limita con India al norte, oeste y este y la Bahía de Bengala al sur; anteriormente parte de India y luego parte de Pakistán; logró la independencia en 1971
manipular - influenciar o controlar astutamente o astutamente
Bolivia - una república sin salida al mar en el centro de América del Sur
estricto: exige una atención estricta a las reglas y procedimientos
vulnerable - capaz de ser herido o lastimado
prod - empujar contra suavemente
hambruna - una grave escasez de alimentos que resulta en inanición y muerte
erradicar - destruir completamente, como si fuera hasta las raíces